Tiles_X,7,,,,,
Tiles_Y,29,,,,,
Tile size,5,,,,,
,,,,,,
,,,,,,
,,,,,,
MapData,,,,,,
1,1,1,1,1,1,1
1,4,4,4,4,4,1
1,4,4,4,4,4,1
1,4,4,4,4,4,1
1,4,4,4,4,4,1
1,4,4,4,4,4,1
1,4,4,4,4,4,1
1,4,4,4,4,4,1
1,4,4,3,4,4,1
1,4,4,4,4,4,1
1,4,4,4,4,4,1
1,4,4,4,4,4,1
1,4,4,4,4,4,1
1,4,4,4,4,4,1
1,4,4,4,4,4,1
1,4,3,4,4,4,1
1,4,4,4,4,4,1
1,4,4,4,4,4,1
1,4,4,4,4,4,1
1,4,4,4,4,4,1
1,4,4,4,4,4,1
1,4,4,4,2,4,1
1,4,4,4,2,4,1
1,4,2,4,4,4,1
1,4,4,4,4,4,1
1,4,4,4,4,4,1
1,4,4,4,4,4,1
1,4,4,4,4,4,1
1,1,1,1,1,1,1
